...............................
...............................
...............T...............
...............T...............
...............T...............
...............T...............
...............T...............
...............T...............
...............T...............
...............T...............
...............T...............
...............T...............
...............T...............
...............T...............
...............T...............
..TTTTTTTTTTTTTTTTTTTTTTTTTTT..
...............T...............
...............T...............
...............T...............
...............T...............
...............T...............
...............T...............
...............T...............
...............T...............
...............T...............
...............T...............
...............T...............
...............T...............
...............T...............
...............................
...............................
